11111111111111111111
1P000000C00000000001
10111101111101111001
10000000000000000C01
10111111011111111001
10000000010000000001
10111111010111111E01
1C0000000100000000C1
11111111011111111001
10000000000000000001
10111101111111111001
10000000000000000C01
10111111011111111001
1C000000010000000001
10111111010111111001
100000000100000000C1
10111111011111111001
1C000000000000000001
10111111111111111001
11111111111111111111
