1111111111
1000000001
101010E001
1C00000C01
11111C1111
10C00P0001
1110101011
100000C001
1111111111
