1111111111
1000C00E01
1010101011
1C000000C1
1011111011
1C000C0001
1010101011
1C00P000C1
1111111111
