1111111111
1000C00E01
1010101011
1C00000001
11111P0111
1C000C0001
1110111011
1C00000001
1111111111
