1111111111
1000000001
1010100001
1C00000C01
1111000111
10C0P0E001
1111101111
100000C001
1111111111
