1111111111
1P000C00E1
1010101011
1C000000C1
1011111101
1C000C0001
1010101011
1C000000C1
1111111111
